{
	"graph" : 	[[0,0,0,0,0,0,0,0,0,0],
				 [0,0,0,0,1,1,1,1,1,0],
				 [0,0,0,0,1,1,0,0,1,0],
				 [0,1,1,1,1,1,1,1,1,0],
				 [0,1,1,1,1,1,1,1,1,0],
				 [0,1,1,1,0,0,1,1,1,1],
				 [0,1,1,1,0,0,1,1,0,0],
				 [0,1,1,1,1,1,1,1,0,0],
				 [0,1,0,0,1,1,1,1,1,0],
				 [0,0,0,0,0,0,0,0,0,0]],
	"char" : 	"mozart",
	"startX":	500,
	"startY":	500,
	"music":	{
					"name" : "heaven",
					"loop" : true,
					"file" : "heaven.ogg"
				}
}